4 3 3 3 3 3 3 3 3 3 3 5 0 4 3 3 3 3 3 3 3 3 3 5 0
2 0 0 0 0 0 0 0 0 0 0 2 0 2 0 0 0 0 0 0 0 0 0 2 0
2 0 4 3 3 5 0 4 3 5 0 2 0 2 0 4 3 5 0 4 3 5 0 2 0
2 0 2 0 0 2 0 2 0 2 0 2 0 2 0 2 0 2 0 2 0 2 0 2 0
2 0 7 3 3 6 0 7 3 6 0 7 3 6 0 7 3 6 0 7 3 6 0 2 0
2 0 0 0 0 0 0 0 0 0 0 0 0 0 0 0 0 0 0 0 0 0 0 2 0
2 0 4 3 3 5 0 4 5 0 3 3 3 3 3 0 4 5 0 4 3 5 0 2 0
2 0 7 3 3 6 0 2 2 0 0 0 2 0 0 0 2 2 0 7 3 6 0 2 0
2 0 0 0 0 0 0 2 7 3 5 0 2 0 4 3 6 2 0 0 0 0 0 2 0
2 0 4 3 5 0 0 2 4 3 6 0 2 0 7 3 5 2 0 4 3 5 0 2 0
2 0 2 0 2 0 0 2 2 0 0 0 0 0 0 0 2 2 0 2 0 2 0 2 0
2 0 7 3 6 0 0 7 6 0 3 3 3 3 3 0 7 6 0 7 3 6 0 2 0
2 0 0 0 0 0 0 0 0 0 0 0 0 0 0 0 0 0 0 0 0 0 0 2 0
7 3 3 3 3 3 5 0 0 4 3 3 0 3 3 5 0 0 4 3 3 3 3 6 0
3 3 3 3 3 3 6 0 0 2 0 0 0 0 0 2 0 0 7 3 3 3 3 3 0
0 0 0 0 0 0 0 0 0 7 3 3 3 3 3 6 0 0 0 0 0 0 0 0 0
3 3 3 3 3 3 5 0 0 0 0 0 0 0 0 0 0 0 4 3 3 3 3 3 0
4 3 3 3 3 3 6 0 2 0 4 3 3 3 5 0 2 0 7 3 3 3 3 5 0
2 0 0 0 0 0 0 0 2 0 7 5 0 4 6 0 2 0 0 0 0 0 0 2 0
2 0 4 3 3 5 0 0 0 0 0 7 3 6 0 0 0 0 4 3 3 5 0 2 0
2 0 7 3 5 2 0 0 0 0 0 0 0 0 0 0 0 0 2 4 3 6 0 2 0
2 0 0 0 2 2 0 4 3 3 3 3 3 3 3 3 5 0 2 2 0 0 0 2 0
2 0 3 0 7 6 0 7 3 3 3 3 3 3 3 3 6 0 7 6 0 3 0 2 0
2 0 0 0 0 0 0 0 0 0 0 0 0 0 0 0 0 0 0 0 0 0 0 2 0
7 3 3 3 3 3 3 3 3 3 3 3 3 3 3 3 3 3 3 3 3 3 3 6 0